0011111111
1000100001
1000100101
1011100101
1000100101
1010100101
1010100101
1010100101
1010000100
1111111110